111111100000000
100000100000000
100000100111110
101310111040010
103930000404010
101310111040010
100000100111110
100000100000000
111111100000000
000000000000000
