111111100000000
100340100000000
101010100000000
100300100000000
101014100000000
109500100000000
111111100000000
000000000000000
000000000000000
000000000000000
