000111110000000
111190010000000
100354010000000
100000110000000
100111110000000
111100000000000
000000000000000
000000000000000
000000000000000
000000000000000
